WE ./textures/west.xpm
NO ./textures/north.xpm
SO ./textures/south.xpm
EA ./textures/east.xpm
C 0,0,118
F 0,97,32

11111
100W1
10001
11111