WE ./images/south.xpm
NO ./images/north.xpm
SO ./images/west.xpm
EA ./images/east.xpm
C 0,0,120
F 0,56,17

11111
100N1
10001
11111