WE ./textures/west.xpm
NO ./textures/north.xpm
SO ./textures/south.xpm
EA ./textures/east.xpm
C 70,70,70
F 100,100,100

11111
10001
10001
10001
10001
10001
11001
10011
10001
11101
10N01
10001
11111