NO ./sprites/wall.xpm
SO ./sprites/wall.xpm
WE ./sprites/wall.xpm
EA ./sprites/wall.xpm
C 140,125,10
F 125,200,10

11111111
10000001
10010001
10000101
1N000001
11111111