NO s
SO ./sprites/wall.xpm
WE ./sprites/wall.xpm
EA ./sprites/wall.xpm
F 125,200,10
C 140,125,10

11111111
10000001
10010001
10000101
1N000001
11111111