NO ./textures/north.xpm
SO ./textures/south.xpm
WE ./textures/west.xpm
EA ./textures/east.xpm

F 164,169,20
C 153,204,255

    11xxx
   1001xx
  100000x
 1000N001
1111111111